[config]
width=50
height=30
tileset_path=art/tileset/spr_tileset_sunnysideworld_16px.png
tile_size=16
tileset_cols=32
room_id=olivewood
room_name=Olivewood
music_path=audio/music/ambient.ogg
camera_bounds=0,0,800,480
collision_bounds=0,0,800,480

[base_data]
1,2,3,1,2,3,1,2,3,1,2,3,1,2,3,1,2,3,1,2,3,1,2,3,1,2,3,1,2,3,1,2,3,1,2,3,1,2,3,1,2,3,1,2,3,1,2,3,1,2
2,3,1,2,3,1,2,3,1,2,3,1,2,3,1,2,3,1,2,3,1,2,3,1,2,3,1,2,3,1,2,3,1,2,3,1,2,3,1,2,3,1,2,3,1,2,3,1,2,3
3,1,2,3,1,2,3,1,2,3,1,2,3,1,2,3,1,2,3,1,2,3,1,2,3,1,2,3,1,2,3,1,2,3,1,2,3,1,2,3,1,2,3,1,2,3,1,2,3,1
33,34,35,33,34,35,33,34,35,33,34,35,33,34,35,33,34,35,33,34,35,33,34,35,33,34,35,33,34,35,33,34,35,33,34,35,33,34,35,33,34,35,33,34,35,33,34,35,33,34
34,35,33,34,35,33,34,35,33,34,35,33,34,35,33,34,35,33,34,35,33,34,35,33,34,35,33,34,35,33,34,35,33,34,35,33,34,35,33,34,35,33,34,35,33,34,35,33,34,35
35,33,34,35,33,34,35,33,34,35,33,34,35,33,34,35,33,34,35,33,34,35,33,34,35,33,34,35,33,34,35,33,34,35,33,34,35,33,34,35,33,34,35,33,34,35,33,34,35,33
65,66,1,65,66,2,65,66,3,65,66,1,65,66,2,65,66,3,65,66,1,65,66,2,65,66,3,65,66,1,65,66,2,65,66,3,65,66,1,65,66,2,65,66,3,65,66,1,65,66
2,65,66,66,1,2,66,1,3,66,2,1,66,2,3,66,3,1,66,3,2,66,1,2,66,1,3,66,2,1,66,2,3,66,3,1,66,3,2,66,1,2,66,1,3,66,2,1,66,2
3,66,3,1,66,3,1,2,3,1,2,3,1,2,3,1,2,3,1,2,3,1,2,3,1,2,3,1,2,3,1,2,3,1,2,3,1,2,3,1,2,3,1,2,3,1,2,3,1,2
3,1,2,3,1,2,2,3,1,2,3,1,2,3,1,2,3,1,2,3,1,2,3,1,2,3,1,2,3,1,2,3,1,2,3,1,2,3,1,2,3,1,2,3,1,2,3,1,2,3
1,2,3,1,2,3,3,1,2,3,1,2,3,1,2,3,1,2,3,1,2,3,1,2,3,1,2,3,1,2,3,1,2,3,1,2,3,1,2,3,1,2,3,1,2,3,1,2,3,1
2,3,1,2,3,1,33,34,35,33,34,35,33,34,35,33,34,35,33,34,35,33,34,35,33,34,35,33,34,35,33,34,35,33,34,35,33,34,35,33,34,35,33,34,35,33,34,35,33,34
35,33,34,35,33,34,34,35,33,34,35,33,34,35,33,34,35,33,34,35,33,34,35,33,34,35,33,34,35,33,34,35,33,34,35,33,34,35,33,34,35,33,34,35,33,34,35,33,34,35
33,34,35,33,34,35,35,33,34,35,33,34,35,33,34,35,33,34,35,33,34,35,33,34,35,33,34,35,33,34,35,33,34,35,33,34,35,33,34,35,33,34,35,33,34,35,33,34,35,33
34,35,33,34,35,33,65,66,1,65,66,2,65,66,3,65,66,1,65,66,2,65,66,3,65,66,1,65,66,2,65,66,3,65,66,1,65,66,2,65,66,3,65,66,1,65,66,2,65,66
3,65,66,1,65,66,2,65,66,66,1,2,66,1,3,66,2,1,66,2,3,66,3,1,66,3,2,66,1,2,66,1,3,66,2,1,66,2,3,66,3,1,66,3,2,66,1,2,66,1
3,66,2,1,66,2,3,66,3,1,66,3,1,2,3,1,2,3,1,2,3,1,2,3,1,2,3,1,2,3,1,2,3,1,2,3,1,2,3,1,2,3,1,2,3,1,2,3,1,2
3,1,2,3,1,2,3,1,2,3,1,2,2,3,1,2,3,1,2,3,1,2,3,1,2,3,1,2,3,1,2,3,1,2,3,1,2,3,1,2,3,1,2,3,1,2,3,1,2,3
1,2,3,1,2,3,1,2,3,1,2,3,3,1,2,3,1,2,3,1,2,3,1,2,3,1,2,3,1,2,3,1,2,3,1,2,3,1,2,3,1,2,3,1,2,3,1,2,3,1
2,3,1,2,3,1,2,3,1,2,3,1,33,34,35,33,34,35,33,34,35,33,34,35,33,34,35,33,34,35,33,34,35,33,34,35,33,34,35,33,34,35,33,34,35,33,34,35,33,34
35,33,34,35,33,34,35,33,34,35,33,34,34,35,33,34,35,33,34,35,33,34,35,33,34,35,33,34,35,33,34,35,33,34,35,33,34,35,33,34,35,33,34,35,33,34,35,33,34,35
33,34,35,33,34,35,33,34,35,33,34,35,35,33,34,35,33,34,35,33,34,35,33,34,35,33,34,35,33,34,35,33,34,35,33,34,35,33,34,35,33,34,35,33,34,35,33,34,35,33
34,35,33,34,35,33,34,35,33,34,35,33,65,66,1,65,66,2,65,66,3,65,66,1,65,66,2,65,66,3,65,66,1,65,66,2,65,66,3,65,66,1,65,66,2,65,66,3,65,66
1,65,66,2,65,66,3,65,66,1,65,66,2,65,66,66,1,2,66,1,3,66,2,1,66,2,3,66,3,1,66,3,2,66,1,2,66,1,3,66,2,1,66,2,3,66,3,1,66,3
2,66,1,2,66,1,3,66,2,1,66,2,3,66,3,1,66,3,1,2,3,1,2,3,1,2,3,1,2,3,1,2,3,1,2,3,1,2,3,1,2,3,1,2,3,1,2,3,1,2
3,1,2,3,1,2,3,1,2,3,1,2,3,1,2,3,1,2,2,3,1,2,3,1,2,3,1,2,3,1,2,3,1,2,3,1,2,3,1,2,3,1,2,3,1,2,3,1,2,3
1,2,3,1,2,3,1,2,3,1,2,3,1,2,3,1,2,3,3,1,2,3,1,2,3,1,2,3,1,2,3,1,2,3,1,2,3,1,2,3,1,2,3,1,2,3,1,2,3,1
2,3,1,2,3,1,2,3,1,2,3,1,2,3,1,2,3,1,33,34,35,33,34,35,33,34,35,33,34,35,33,34,35,33,34,35,33,34,35,33,34,35,33,34,35,33,34,35,33,34
35,33,34,35,33,34,35,33,34,35,33,34,35,33,34,35,33,34,34,35,33,34,35,33,34,35,33,34,35,33,34,35,33,34,35,33,34,35,33,34,35,33,34,35,33,34,35,33,34,35
33,34,35,33,34,35,33,34,35,33,34,35,33,34,35,33,34,35,35,33,34,35,33,34,35,33,34,35,33,34,35,33,34,35,33,34,35,33,34,35,33,34,35,33,34,35,33,34,35,33

[deco_data]
0,0,0,0,257,0,0,0,0,0,0,0,0,0,0,0,0,0,0,0,0,258,0,0,0,0,0,0,0,0,0,0,0,0,0,259,0,0,0,0,0,0,0,0,0,0,0,0,0,0
0,0,0,0,0,0,0,260,0,0,0,0,0,0,0,0,0,0,0,0,0,0,0,0,0,0,289,0,0,0,0,0,0,0,0,0,0,0,0,0,290,0,0,0,0,0,0,0,0,0
0,0,0,291,0,0,0,0,0,0,0,0,0,0,0,0,292,0,0,0,0,0,0,0,0,0,0,0,0,0,0,0,0,0,321,0,0,0,0,0,0,0,0,0,0,0,322,0,0,0
0,0,0,0,0,0,0,0,0,0,323,0,0,0,0,0,0,0,0,0,0,0,0,0,324,0,0,0,0,0,0,0,0,0,0,0,0,0,0,353,0,0,0,0,0,0,0,0,0,354
0,0,0,0,0,0,0,0,0,0,0,0,0,0,0,0,0,0,0,355,0,0,0,0,0,0,0,0,0,0,0,356,0,0,0,0,0,0,0,0,0,0,0,0,0,0,0,0,0,0
0,0,257,0,0,0,0,0,0,0,0,0,0,0,0,0,0,0,0,0,0,0,0,0,0,0,0,0,258,0,0,0,0,0,0,0,0,0,0,0,0,0,0,259,0,0,0,0,0,0
0,0,0,0,0,0,0,0,0,0,0,260,0,0,0,0,0,0,0,0,0,0,0,0,0,0,0,0,0,0,0,0,0,0,0,0,289,0,0,0,0,0,0,0,0,0,0,0,0,290
0,0,0,0,0,0,0,0,0,291,0,0,0,0,0,0,0,0,0,0,0,0,292,0,0,0,0,0,0,0,0,0,0,0,0,0,0,0,0,0,0,0,321,0,0,0,0,0,0,0
0,0,0,0,0,0,0,0,0,0,0,0,0,0,322,0,0,0,0,0,0,0,0,0,0,0,0,323,0,0,0,0,0,0,0,0,0,0,0,0,0,0,0,0,0,0,324,0,0,0
0,0,0,0,0,353,0,0,0,0,0,0,0,0,0,0,0,0,0,0,0,354,0,0,0,0,0,0,0,0,0,0,0,355,0,0,0,0,0,0,0,0,0,0,0,0,0,0,0,356
0,0,0,0,0,0,0,0,0,0,0,0,0,0,0,0,0,0,257,0,0,0,0,0,0,0,0,0,0,0,0,0,0,0,0,0,0,0,258,0,0,0,0,0,0,0,0,0,0,0
0,259,0,0,0,0,0,0,0,0,0,0,0,0,0,260,0,0,0,0,0,0,0,0,0,0,0,0,0,0,0,0,0,0,0,0,0,0,0,0,0,289,0,0,0,0,0,0,0,0
0,0,0,0,0,0,0,0,290,0,0,0,0,0,0,0,0,0,0,0,0,0,0,291,0,0,0,0,0,0,0,0,0,0,0,0,0,0,0,0,0,0,0,0,292,0,0,0,0,0
0,0,0,0,0,0,0,0,0,0,0,0,321,0,0,0,0,0,0,0,0,0,0,0,0,0,0,0,322,0,0,0,0,0,0,0,0,0,0,0,0,0,0,0,0,0,323,0,0,0
0,0,0,324,0,0,0,0,0,0,0,0,0,0,0,0,0,353,0,0,0,0,0,0,0,0,0,0,0,0,0,354,0,0,0,0,0,0,0,0,0,0,0,0,0,0,0,355,0,0
0,0,0,0,0,0,356,0,0,0,0,0,0,0,0,0,0,0,0,257,0,0,0,0,0,0,0,0,0,0,0,0,0,0,0,258,0,0,0,0,0,0,0,0,0,0,0,0,0,0
0,0,0,0,0,0,0,0,0,0,0,0,259,0,0,0,0,0,0,0,0,0,0,0,260,0,0,0,0,0,0,0,0,0,0,0,0,0,0,289,0,0,0,0,0,0,0,0,0,0
290,0,0,0,0,0,0,0,0,0,0,0,0,0,0,0,0,0,291,0,0,0,0,0,0,0,0,0,0,0,0,0,292,0,0,0,0,0,0,0,0,0,0,0,321,0,0,0,0,0
0,0,0,0,322,0,0,0,0,0,0,0,0,0,0,0,0,0,0,0,0,0,323,0,0,0,0,0,0,0,0,0,0,0,0,0,0,324,0,0,0,0,0,0,0,0,0,0,0,0
0,0,0,0,0,0,0,0,353,0,0,0,0,0,0,0,354,0,0,0,0,0,0,0,0,0,0,355,0,0,0,0,0,0,0,0,0,0,0,0,0,356,0,0,0,0,0,0,0,0
0,0,257,0,0,0,0,0,0,0,0,0,0,0,0,0,0,0,0,0,258,0,0,0,0,0,0,0,0,0,0,0,0,0,0,0,259,0,0,0,0,0,0,0,0,0,0,260,0,0
0,0,0,0,0,0,0,289,0,0,0,0,0,0,290,0,0,0,0,0,0,0,0,0,0,0,0,0,0,291,0,0,0,0,0,0,0,0,0,0,0,0,0,292,0,0,0,0,0,0
321,0,0,0,0,0,0,0,0,0,0,0,322,0,0,0,0,0,0,0,0,0,0,0,323,0,0,0,0,0,0,0,0,0,0,0,0,0,324,0,0,0,0,0,0,0,0,0,0,0
0,0,0,0,0,353,0,0,0,0,0,0,0,0,0,0,0,0,354,0,0,0,0,0,0,0,0,0,0,0,355,0,0,0,0,0,0,0,0,0,0,0,0,0,0,356,0,0,0,0
0,0,0,356,0,0,0,0,0,0,0,0,0,0,0,0,0,0,0,0,0,0,0,257,0,0,0,0,0,0,0,0,0,0,0,258,0,0,0,0,0,0,0,0,0,0,0,0,0,0
0,0,0,0,0,0,259,0,0,0,0,0,0,0,0,260,0,0,0,0,0,0,0,0,0,0,0,0,289,0,0,0,0,0,0,0,0,0,0,0,290,0,0,0,0,0,0,0,0,0
0,291,0,0,0,0,0,0,0,0,0,292,0,0,0,0,0,0,0,0,0,0,0,0,0,0,321,0,0,0,0,0,0,0,0,0,0,322,0,0,0,0,0,0,0,0,323,0,0,0
0,0,0,0,0,0,0,0,324,0,0,0,0,0,0,0,0,353,0,0,0,0,0,0,0,0,0,0,0,0,0,354,0,0,0,0,0,0,0,0,0,0,0,355,0,0,0,0,0,356

[entity_data]
240,256,0,0,0,false,false,0,0,,,
272,256,0,0,0,false,false,0,0,,,
300,200,1,0,0,false,false,0,0,,,
400,300,1,0,0,false,false,0,0,,,
350,150,1,0,0,false,false,0,0,,,
150,200,2,1,0,false,false,32,32,,,
350,200,2,2,0,false,false,32,32,,,
240,150,3,0,1,false,false,64,16,,1,2,1,2,1,2
300,300,4,0,0,false,false,16,16,art/elements/crops/wood.png,,
752,208,6,0,0,false,false,32,64,,desert,from_olivewood
0,208,6,0,0,false,false,32,64,,small_room,from_olivewood
